2 15 23 
#######################
#          #     *b   #
##*#*#*##*##*##*##**###
#          *   1 *  s #
#*#*#*###*#####*###*# #
#  b  *    * f  *  2  #
#*#*#*#  ! ###*###*##*#
# 3   #    *  1   * f #
###*##*##*####*#*#*##*#
#     *  x *  s  *   2#
#2      ##*###*#*####*#*##
#*##*###   1   #      #
#      *#*#*#*#*   3  #
#  1   #   1   #      #
#######################

//LEVEL4: 3 Oneal, 4 Ballom, 2 Doll