9 15 23
#######################
#     f         1     #
#    ##    #    ##    #
#  #  * #     # *4 #  #
#  # s # 4    #  * #  #
#b   ##    #    ##    #
#      4     5     1  #
# ###  ### f ###  ### #
# !    1    5   2     #
#    ##  2 #    ##    #
#  # s  # 1   #  * #  #
#  #  * #  f  # x  #  #
#    ##    #    ##  **#
#      2    5    3  *5#
#######################