10 15 23
#######################
#                     #
# ################### #
# #                 # #
# # ############### # #
# # #             # # #
# # # ########### # # #
# # # #    x    # # # #
# # # #  ######## # # #
# # # #           # # #
# # # ############# # #
# # #               # #
# # ################# #
# #                   #
#######################