7 15 23
#######################
#    #              * #
# ##*#### ########### #
#  # # 1#           # #
#* # *2 ########### # #
##   # 1#2# #   # # # #
#    ####*#2#   #3# # #
# #   *#  #*#   #*# #*#
# # ####  #   #   # #5#
# #    #  #   #   # # #
# #    #  # #   # # # #
# #### #  *  ###  # # #
#  *** #  # *1#4* * # #
#  *1*    ######### #x#
#######################