4 15 23
#######################
#     f         1     #
#    ##    #    ##    #
#  #  * #     # *4 #  #
#  # s #      #  * #  #
#b   ##    #    ##    #
#                  1  #
# ###  ### f ###  ### #
# !    1        2     #
#    ##    #    ##    #
#  # s  #     #  * #  #
#  #  * #  f  # x  #  #
#    ##    #    ##  **#
#      2         3  *5#
#######################