2 15 23
#######################
#      g      *  2    #
#b#*#****###*f*###*##f#
#       2bb           #
#              s      #
#**##b*#*#*#*!###***#*#
#  3   3              #
#          f       f  #
#*f#*##x*##*#*##b*#*#*#
#          2       1  #
#     1    !b         #
#*#s#*#*##*###s#b#*#!*#
#     1   3      2    #
#     2   2           #
#######################