2 15 23
#######################
#          #   *b     #
##*#*#*##*##*##*##**###
#          *  2 *  s  #
#          ####*###*# #
###*#*###*##   	#     #
#     *    #   	*  1  #
#*#*#*#  ! #*#####*##*#
# 3   #    *     * f  #
###*##*##*##*##*###*###
#  2   *         *   x#
#*##*####*###*#*###*###
#      *        *     #
#  1   #   1    #     #
#######################

//LEVEL1: 2 Oneal, 2 Ballom, 1 Doll