3 15 23
#######################
#                     #
#b *#*b**###*f*###*# s#
# *     2      1    * #
#* #     #s *!     *  #
#  *   !*     f*   #  #
#  b **    *    #* f  #
#  #      *x*      #  #
#  # ##    *    #b *  #
#  * 3 **     **   b  #
#  s     #* ##     #  #
# f       2         * #
#* #b*#**##*#**##f*# *#
#      3          4   #
#######################