2 15 23
#######################
#         #     *b    #
##*#*#*#*##*##*##**####
#          *   1 * s  #
#        f ###*##*#*#*#
###*#*##*##    #      #
#  b  *   * f  *   3  #
#*#*#*# ! ###*#*##*##*#
# 1   #   *      * f  #
###*##*##*###*#####*###
#      #  x #  s #    #
#  2   *    *    * 2  #
#*#*#*##*#*#*#*###*#*##
#    1 *      1 *    2#
#######################

//LEVEL3: 3 Oneal, 3 Ballom, 1 Doll